60 60 60 60 60 60 60 60 60 60 60 60 60 60 60 60 60 60 60 60 60 60 60 60 60 60 60 60 60 60 60 60 60 60 60 60 60 60 60 60 60 60 60 60 60 60 60 60 60 60 60 60 60 60 60 60 60 60 60 60 60 60 60 60 60 60 60 60 60 60 60 60 77 60 60 60 60 60 60 60 60 60 60 60 60 60 60 60 60 60 60 
60 60 60 60 60 60 60 60 60 60 60 60 60 60 60 60 60 60 60 60 60 60 60 60 60 60 60 60 60 60 60 60 77 60 60 60 60 60 60 60 60 60 60 60 60 60 60 60 60 60 60 60 60 60 60 60 60 60 60 60 60 60 60 60 60 60 60 60 60 60 60 60 60 60 60 60 60 60 60 60 60 60 60 60 60 60 60 60 60 60 60 
60 60 60 60 60 60 60 60 60 60 60 60 60 60 60 60 60 60 60 60 60 60 60 60 60 60 60 60 60 60 60 60 60 60 60 60 60 60 60 60 60 60 60 60 60 60 60 60 60 60 60 60 60 60 60 60 60 60 60 60 60 60 60 60 60 60 60 77 60 60 60 60 60 60 60 60 60 60 60 60 77 60 60 60 60 60 60 60 60 60 60 
60 60 60 60 60 60 60 60 60 60 60 60 60 60 60 60 60 60 60 60 60 60 60 60 60 60 60 60 60 60 60 60 60 60 60 60 60 60 60 77 60 60 60 60 60 60 60 60 60 60 60 60 60 60 60 60 60 60 60 60 77 60 60 60 60 60 60 60 60 60 60 60 60 60 60 60 60 60 60 60 60 60 60 60 60 77 60 60 60 60 60 
60 60 60 60 60 60 60 60 60 60 60 60 60 60 77 77 60 60 60 60 60 77 60 60 60 60 60 60 60 60 60 60 60 60 60 60 60 60 60 60 60 60 60 60 60 60 60 60 60 60 60 60 77 60 60 60 60 60 60 60 60 60 60 60 60 60 60 60 60 71 69 69 69 69 73 60 60 60 60 60 60 60 60 60 60 77 77 77 60 60 60 
60 60 60 60 60 60 60 60 60 60 60 77 77 77 77 60 60 60 60 60 60 60 60 60 60 71 69 69 69 69 69 69 73 60 60 60 60 60 60 60 60 60 60 60 60 60 60 60 60 60 77 60 60 60 60 60 60 60 60 60 60 60 60 60 60 71 69 69 69 72 79 79 79 79 74 69 73 60 60 60 60 60 60 60 60 60 60 60 77 77 60 
60 60 60 60 60 60 60 60 60 60 77 77 60 60 60 77 60 60 60 60 60 60 60 71 69 72 79 79 79 79 79 79 74 69 69 73 60 60 60 60 60 60 60 60 77 60 60 60 60 60 60 60 60 60 60 60 60 60 60 60 71 69 69 69 69 72 79 79 79 79 79 79 79 79 79 79 74 69 73 60 60 60 60 60 60 60 60 60 60 60 60 
60 60 60 60 60 60 60 60 60 60 60 60 60 60 77 60 60 60 60 60 60 71 69 72 79 79 79 79 79 79 79 79 79 79 79 74 73 60 60 60 60 60 60 60 60 60 60 60 60 60 60 60 60 60 60 60 60 71 69 69 72 79 79 79 79 79 79 79 79 79 79 79 79 78 79 79 79 79 74 73 60 60 60 60 60 60 60 60 60 60 60 
60 60 60 60 60 60 60 60 60 60 60 60 60 60 60 60 60 60 60 60 71 72 79 79 79 79 79 79 79 79 78 79 79 79 79 79 79 69 73 60 60 60 60 60 60 60 60 60 60 60 60 60 60 71 69 69 69 72 79 79 79 79 79 79 79 79 79 79 79 79 79 79 79 79 79 79 79 79 79 74 69 73 60 60 77 60 60 60 60 60 60 
60 60 60 60 60 60 60 60 60 60 60 77 60 60 60 60 60 60 71 69 72 79 79 79 79 79 79 79 79 79 79 79 79 79 79 79 79 79 74 69 69 69 69 69 69 69 69 69 69 69 69 69 69 72 79 79 79 79 79 79 79 78 79 79 79 79 79 79 79 79 79 79 79 79 79 79 78 79 79 79 79 74 73 60 60 60 60 60 60 60 60 
60 60 60 60 60 60 60 60 60 60 60 60 60 60 60 60 60 71 72 79 79 79 79 79 79 79 79 79 61 61 61 61 61 61 61 79 79 79 79 79 79 79 79 79 79 79 79 79 79 79 79 79 79 79 79 79 79 79 79 79 79 79 79 79 79 79 79 79 79 79 79 79 79 79 79 79 79 79 79 79 79 79 79 73 60 60 60 77 60 60 60 
60 60 60 60 60 60 60 60 60 60 60 60 60 60 60 71 69 72 79 79 79 79 79 79 78 61 61 61 79 79 79 79 79 79 79 78 61 79 79 79 79 79 79 79 79 79 79 79 79 79 79 79 79 79 79 79 79 79 79 79 79 79 79 79 79 79 79 79 79 79 79 79 79 79 79 79 79 79 79 79 79 79 79 74 73 60 60 60 60 60 60 
60 60 60 60 60 60 60 60 60 60 60 60 60 71 69 72 79 78 79 79 79 79 79 79 79 61 79 79 79 79 79 79 79 79 79 79 79 79 79 79 79 79 79 79 79 79 79 79 79 79 79 79 61 61 61 79 79 61 61 61 61 61 61 61 61 61 61 61 61 79 81 82 82 82 82 82 82 82 82 18 79 79 79 79 68 60 60 60 60 60 60 
60 60 60 60 60 60 60 60 77 60 60 60 71 72 79 78 78 78 78 78 79 79 79 79 61 79 79 79 79 79 79 79 79 79 79 79 79 79 79 79 79 79 79 79 79 79 79 79 61 61 61 61 79 79 79 61 61 61 81 82 82 82 82 82 82 82 82 82 82 82 17 61 61 61 79 79 79 79 79 79 79 79 79 79 68 60 60 60 60 60 60 
60 60 60 60 60 60 60 60 60 60 60 60 70 79 79 79 79 79 79 79 16 82 82 82 82 82 82 82 82 11 61 61 61 61 61 61 61 61 79 79 79 79 79 79 81 82 82 82 82 82 82 11 81 82 82 82 82 82 17 61 79 79 79 61 61 79 79 79 79 79 79 79 61 61 79 79 79 79 79 79 79 79 79 79 68 60 60 60 60 60 60 
60 60 60 60 60 60 60 60 60 77 60 60 70 79 79 78 78 78 78 78 79 79 61 79 79 79 79 79 79 10 82 82 82 82 82 82 82 82 82 82 82 82 82 82 17 79 79 79 79 79 79 80 12 79 79 79 79 79 61 61 61 61 61 61 79 61 61 61 79 79 79 61 79 79 79 79 79 79 79 79 79 79 79 79 68 60 60 60 60 60 60 
60 60 60 60 60 60 60 60 60 60 60 60 64 65 79 79 79 79 79 79 79 79 79 79 79 79 79 79 79 79 79 79 79 79 79 79 79 79 79 79 79 79 61 61 61 61 61 79 79 79 61 80 12 79 79 79 79 79 79 79 79 79 79 79 61 61 61 61 79 79 61 79 79 79 79 79 79 79 79 79 79 79 79 79 88 60 60 77 60 60 60 
60 60 60 60 60 60 60 60 60 60 60 60 60 64 65 79 79 79 79 79 79 79 79 79 79 61 78 79 79 79 79 79 79 79 79 79 79 79 79 79 61 78 79 79 79 79 79 79 61 61 79 80 12 79 79 79 78 79 79 79 79 79 61 78 79 79 79 61 61 61 79 79 79 79 79 79 79 79 79 79 79 79 79 88 60 60 60 60 60 60 60 
60 60 60 60 60 60 60 60 60 60 60 60 60 60 70 79 79 79 79 79 61 79 79 79 79 79 61 61 61 79 79 79 79 79 79 79 79 79 79 61 79 79 79 79 79 79 79 79 79 79 79 80 12 61 79 79 79 79 79 79 79 79 61 79 79 79 79 79 79 79 79 61 61 79 78 79 79 79 79 79 79 79 88 60 60 60 60 60 60 60 60 
60 60 60 60 60 60 60 60 60 60 60 60 60 60 64 65 79 79 79 79 61 61 61 79 79 79 79 79 61 61 61 61 79 79 78 79 79 79 61 79 79 79 79 79 79 61 61 79 79 79 79 80 12 79 79 61 79 79 79 79 61 61 79 79 79 79 61 79 79 61 79 79 79 61 61 79 79 79 79 79 67 88 60 60 60 60 60 60 60 60 60 
60 60 60 60 60 60 60 60 60 60 60 60 77 60 60 70 79 79 79 79 61 79 61 61 79 79 79 79 79 79 61 61 61 61 61 61 61 61 61 61 79 79 79 79 79 79 79 79 61 79 79 80 12 79 79 79 79 79 61 79 79 79 79 79 79 79 78 79 79 79 79 79 79 79 61 61 79 79 79 79 68 60 60 60 77 60 60 60 60 60 60 
60 77 60 60 60 60 60 60 60 60 60 60 60 60 60 64 65 79 79 79 79 61 79 79 61 78 79 79 79 61 79 61 61 79 79 79 61 79 79 78 79 79 79 79 79 79 78 79 79 61 61 80 12 79 79 79 79 61 61 79 79 79 79 79 79 61 61 79 79 79 79 79 79 79 79 79 61 78 61 79 79 73 60 60 60 60 60 77 60 60 60 
60 60 60 60 60 71 69 69 69 69 73 60 60 60 60 60 70 79 79 79 79 61 79 79 79 79 61 79 61 61 79 79 79 61 61 61 61 79 79 79 79 79 79 79 79 79 79 79 79 79 79 80 12 79 61 61 61 79 78 79 79 79 79 79 79 79 79 79 79 79 79 79 79 79 78 79 79 78 78 61 79 79 73 60 60 60 60 60 60 60 60 
60 60 60 60 60 70 79 79 79 79 68 60 60 60 60 60 64 65 79 79 79 61 79 79 79 79 79 61 79 79 79 79 79 79 79 61 61 61 61 79 79 79 79 79 79 79 79 79 79 79 79 80 12 61 79 79 79 79 79 61 61 61 61 79 61 79 61 79 79 79 79 79 79 79 79 79 79 79 78 78 61 79 79 73 60 60 60 60 60 60 60 
60 60 60 60 60 70 79 61 61 79 74 73 60 60 60 60 60 70 79 79 79 79 61 79 79 79 61 79 61 79 79 79 79 61 61 61 79 79 79 79 79 61 61 61 61 78 79 61 78 79 61 80 12 79 79 79 79 61 79 79 79 79 79 61 61 61 79 79 79 61 79 79 79 79 79 79 79 79 79 79 79 79 79 79 73 60 60 60 60 60 60 
60 77 60 60 60 70 61 61 61 61 79 74 69 69 69 69 69 72 81 14 14 14 14 14 14 14 14 14 14 14 14 14 14 14 14 14 14 14 14 14 14 14 14 14 14 14 14 14 14 14 14 75 75 14 14 14 14 14 14 14 14 14 14 14 14 14 14 14 11 79 79 79 79 79 79 79 79 79 79 79 79 79 79 79 68 60 60 60 60 60 60 
60 60 60 60 60 70 61 61 61 61 79 67 62 62 62 62 62 65 10 76 76 76 76 15 76 76 76 76 76 15 76 76 76 76 76 76 15 76 76 76 76 76 76 76 76 76 75 75 76 76 76 76 76 76 76 15 76 76 76 76 76 76 76 76 76 76 76 75 12 61 61 61 61 79 79 61 79 78 79 79 79 79 79 79 74 73 60 60 60 60 60 
60 60 60 60 60 70 79 61 61 79 67 63 60 60 60 60 60 70 79 79 79 79 79 61 61 79 79 61 61 79 79 61 79 79 79 79 79 61 61 79 79 79 79 79 61 78 80 12 78 61 79 61 61 79 79 79 79 79 79 79 79 61 79 79 61 61 61 80 12 79 79 79 79 61 61 79 79 79 79 79 79 79 79 79 79 74 73 60 60 60 60 
60 60 60 60 60 70 79 79 79 79 68 60 60 60 60 60 71 72 79 79 79 79 79 61 79 61 61 79 79 79 79 79 79 79 79 79 61 61 79 79 79 61 61 61 79 61 80 12 61 61 61 61 61 61 79 79 79 79 79 79 61 79 79 79 79 79 79 80 75 14 14 14 14 14 14 14 14 14 14 14 11 79 78 79 79 79 68 60 60 60 60 
60 60 60 60 60 64 62 62 62 62 63 60 60 60 60 60 70 79 79 79 79 79 79 61 78 78 78 78 78 78 78 61 79 79 79 79 61 79 79 79 79 79 61 61 61 61 80 12 79 79 79 79 79 79 79 79 79 79 61 61 79 79 79 79 79 79 79 10 76 76 15 76 76 76 76 76 76 76 15 75 12 79 78 79 79 79 68 60 77 60 60 
60 60 60 60 60 60 60 60 60 60 60 60 60 60 60 60 70 79 79 79 61 61 61 78 78 78 78 78 78 78 78 79 79 79 79 79 79 79 79 79 61 61 61 79 79 79 80 12 79 79 79 79 79 79 61 61 78 61 79 79 79 79 79 79 79 79 79 61 61 79 79 79 79 79 79 79 79 79 79 80 12 61 78 79 79 79 68 60 60 60 60 
60 60 60 60 60 60 60 60 60 60 60 60 60 60 60 71 72 79 61 61 79 79 78 78 78 78 78 78 78 78 78 78 78 79 61 79 79 79 61 61 61 79 79 79 79 79 80 12 79 79 79 79 61 61 61 61 61 61 61 79 79 79 78 79 79 79 61 79 79 79 79 79 79 79 79 79 79 79 79 80 12 61 78 78 79 79 68 60 60 60 60 
60 60 60 60 60 60 60 60 60 60 60 60 60 60 60 70 79 61 79 79 79 79 78 78 78 78 78 78 78 78 78 78 78 79 61 61 61 61 79 61 61 61 79 79 79 79 80 12 61 61 61 61 79 79 79 79 79 79 79 61 61 61 61 61 61 61 61 61 61 61 79 78 79 79 79 79 79 61 61 80 12 61 79 78 78 79 68 60 60 60 60 
60 60 60 60 60 77 60 60 60 60 60 60 60 60 71 72 79 61 79 79 79 78 78 78 78 78 78 78 78 78 78 78 78 78 78 79 79 61 61 79 79 79 79 79 79 61 80 12 79 79 79 78 79 79 79 79 79 79 79 79 79 61 61 61 79 79 79 79 79 79 79 79 79 79 79 79 79 79 79 10 17 79 79 79 79 79 68 60 60 60 60 
60 60 60 60 60 60 60 60 60 60 60 60 60 60 70 79 79 79 79 79 79 78 78 78 78 78 78 78 78 78 78 78 61 78 78 61 61 79 79 79 79 79 79 79 79 79 80 12 79 79 79 79 79 79 79 79 57 56 56 56 56 56 56 56 56 56 56 56 56 56 56 56 56 56 56 56 56 56 56 56 59 79 79 79 79 67 88 60 60 60 60 
60 60 60 60 77 60 60 60 60 60 60 60 60 71 72 79 79 79 79 61 61 78 78 78 78 78 78 78 78 78 78 78 78 78 61 79 79 79 79 79 79 79 79 79 79 79 80 12 79 79 79 79 79 79 79 79 53 79 79 79 79 79 81 11 79 79 79 79 13 79 79 79 79 79 79 79 79 79 79 79 58 79 79 79 79 68 60 60 77 60 60 
60 60 60 60 77 60 60 60 60 60 60 60 60 70 79 79 79 61 61 79 78 78 78 78 78 78 78 78 78 78 78 78 78 79 79 79 79 79 79 79 79 79 79 79 79 79 10 17 79 79 79 79 79 79 79 79 53 79 79 61 79 79 80 12 79 79 61 79 10 14 11 79 79 79 81 18 79 79 79 79 58 79 79 79 79 68 60 60 60 60 60 
60 60 60 60 77 60 60 60 60 60 60 60 71 72 61 61 61 79 79 79 78 78 78 78 78 78 78 78 78 78 61 79 79 79 79 79 79 79 79 67 62 62 62 62 62 62 62 62 62 62 62 62 62 62 62 63 52 51 65 61 61 61 10 12 79 79 61 79 79 10 15 11 79 79 83 79 79 79 79 79 58 79 79 79 67 88 60 60 60 60 60 
60 60 60 60 77 60 60 60 60 60 60 71 72 79 79 79 79 79 79 78 78 61 78 78 78 78 78 78 78 79 79 79 79 79 79 79 79 67 62 63 60 60 60 60 60 60 60 60 60 60 60 60 60 60 60 60 60 60 50 79 79 61 79 83 79 79 61 79 79 79 79 84 79 79 80 11 79 79 79 79 58 79 79 79 68 60 60 60 60 60 60 
60 60 60 60 60 60 60 60 60 60 71 72 79 79 79 79 79 79 61 78 61 79 79 79 79 79 79 78 78 79 79 79 79 67 62 62 62 63 60 60 60 60 60 60 60 60 60 60 60 60 60 60 60 60 60 60 60 60 49 65 79 79 79 84 79 79 79 79 79 79 79 79 79 79 80 12 79 79 79 79 58 79 79 67 88 60 60 60 60 60 60 
60 60 77 60 60 60 60 60 60 60 70 79 79 79 79 79 79 79 61 79 61 79 79 79 79 79 79 79 79 79 67 62 62 63 60 60 60 60 60 60 60 60 60 60 71 69 69 69 69 69 69 69 69 69 69 69 40 60 60 48 79 79 79 79 79 79 19 20 21 22 23 79 61 79 10 17 61 61 61 79 58 79 79 68 60 60 60 60 60 60 60 
60 77 77 60 60 60 60 60 60 60 70 79 79 79 79 79 79 79 79 61 79 79 79 79 79 67 62 62 62 62 63 60 60 60 60 60 60 60 60 60 60 71 69 69 79 79 10 17 79 79 79 79 79 79 79 79 39 60 60 47 65 79 61 61 79 79 34 86 86 86 24 79 61 61 79 61 61 79 79 79 58 79 79 88 60 60 60 60 60 60 60 
60 77 60 60 60 60 60 60 60 60 64 65 79 79 79 79 79 79 79 61 79 79 67 62 62 63 60 60 60 60 60 60 60 60 60 60 60 71 69 69 69 79 79 79 61 61 61 61 61 79 79 79 79 79 79 79 38 60 60 60 46 65 79 61 79 79 33 86 86 86 25 79 79 61 79 61 79 79 79 79 58 79 88 85 60 77 60 60 60 60 60 
60 77 77 60 60 60 60 60 60 60 60 70 79 79 79 79 79 79 79 67 62 62 63 60 60 60 60 60 60 60 60 60 60 71 69 69 69 79 79 78 78 79 61 61 79 78 79 79 78 79 79 79 79 79 79 79 53 36 60 77 60 44 79 61 79 79 32 86 86 86 26 79 79 79 79 79 79 13 79 79 58 88 85 60 60 60 60 60 60 60 60 
60 60 77 60 60 60 77 60 60 60 60 64 62 65 79 79 79 67 62 63 60 60 60 60 60 60 60 60 60 60 71 69 69 79 79 78 78 78 78 78 78 78 78 78 78 78 79 79 78 78 78 78 79 79 79 79 53 37 60 60 60 43 79 79 79 79 31 30 29 28 27 79 79 79 81 82 82 17 79 79 88 85 60 60 60 60 60 60 60 60 60 
60 60 77 60 60 60 60 77 60 60 60 60 60 64 62 62 62 63 60 60 77 60 60 60 60 71 69 69 69 69 79 79 79 78 78 78 79 79 79 61 79 79 79 79 79 61 61 61 79 79 79 78 78 79 79 79 53 74 35 41 42 45 79 79 79 61 61 79 79 79 79 79 61 79 84 79 79 79 79 88 85 60 60 60 77 60 60 60 60 60 60 
60 60 60 60 60 60 60 60 60 60 60 60 60 60 60 60 60 60 60 60 60 60 71 69 69 79 79 79 79 78 78 78 78 78 79 79 79 79 79 79 79 79 61 61 61 79 79 79 79 79 79 79 78 78 79 79 53 79 79 79 79 79 79 61 61 61 79 79 79 79 79 79 61 61 61 79 79 79 88 85 60 60 60 60 60 60 60 60 60 60 60 
60 60 60 60 60 60 60 60 60 60 60 77 60 60 60 60 60 60 60 71 69 69 79 79 79 79 78 78 78 78 79 79 79 79 79 61 79 79 79 79 61 61 79 79 79 79 79 79 79 61 79 79 61 78 78 79 53 79 61 61 79 13 79 61 79 79 16 82 14 14 11 79 79 79 61 79 79 88 85 60 60 60 60 60 60 60 60 60 60 60 60 
60 60 60 60 60 60 60 60 60 60 60 60 60 60 60 60 60 60 60 70 79 79 78 79 78 78 78 61 79 79 79 61 61 61 61 61 61 79 79 79 61 79 79 79 79 79 79 61 61 61 79 79 61 79 78 79 53 79 61 61 81 12 79 79 61 79 79 79 10 15 17 79 79 79 79 79 88 85 60 60 60 60 60 60 60 60 60 60 60 60 60 
60 60 60 60 60 60 60 60 60 60 60 60 60 60 77 60 60 60 60 70 79 78 79 79 79 79 79 61 79 79 79 79 79 79 79 61 61 61 79 79 79 61 61 61 61 61 61 79 79 79 79 79 61 79 78 78 53 79 79 79 10 17 79 79 79 79 79 79 79 79 79 79 79 79 79 88 85 60 60 77 60 60 60 60 60 60 60 60 60 60 60 
60 60 60 60 60 60 60 60 60 60 60 60 60 60 60 60 60 60 60 64 65 79 78 79 78 78 78 61 61 79 79 79 79 79 79 79 79 79 79 79 79 61 79 79 79 79 79 79 79 79 79 79 78 78 78 78 55 54 54 54 54 54 54 54 54 54 54 54 54 54 54 54 54 54 88 85 60 60 60 60 60 60 60 60 60 60 60 60 60 60 60 
60 60 60 60 60 60 60 60 60 60 60 60 60 60 60 60 60 60 60 60 64 65 79 79 79 79 78 78 78 78 79 79 79 79 79 79 79 79 61 61 79 79 79 79 79 78 78 78 78 78 78 78 78 79 79 79 79 79 79 79 79 79 79 79 79 79 79 79 67 62 62 62 62 88 85 60 60 60 60 60 60 60 60 60 60 60 60 60 60 60 60 
60 60 60 60 60 60 60 60 60 60 60 60 60 60 60 60 60 60 60 60 60 64 62 62 62 62 62 62 65 78 78 78 78 78 78 78 78 78 78 78 78 78 78 78 78 78 79 79 79 79 79 79 61 79 79 79 79 79 79 79 79 79 79 79 67 62 62 62 88 60 60 60 60 60 60 60 60 77 60 60 60 60 60 60 60 60 60 60 60 60 60 
60 60 60 60 60 60 60 60 60 60 60 60 60 60 60 60 60 60 77 60 60 60 60 60 60 60 60 60 64 62 62 62 62 62 62 62 65 79 79 79 79 61 61 79 79 79 79 79 79 79 79 79 79 79 79 79 79 79 79 67 62 62 62 62 63 60 60 77 60 60 60 60 60 60 60 60 60 60 60 60 60 60 60 60 60 77 60 60 60 60 60 
60 60 60 60 60 77 77 60 60 60 60 60 60 60 60 60 60 60 60 60 60 60 60 60 60 60 60 60 60 60 60 60 60 60 60 60 64 62 62 62 62 62 62 62 62 65 79 79 67 66 65 79 79 79 67 62 62 62 62 88 60 60 60 60 60 60 60 60 60 60 60 60 60 60 60 60 60 60 60 60 60 60 60 60 77 77 60 60 60 60 60 
60 60 60 60 60 60 60 77 77 60 60 60 60 60 60 60 60 60 60 60 60 60 60 60 60 77 60 60 60 60 60 60 60 60 60 60 60 60 60 60 60 60 60 60 60 64 62 62 63 85 64 62 62 62 63 60 60 60 60 60 60 60 60 60 77 60 60 60 60 60 60 60 60 60 60 60 60 60 60 60 60 77 77 77 77 60 60 60 60 60 60 
60 60 60 60 60 60 60 60 60 77 77 60 60 60 60 60 60 60 60 60 60 60 60 60 60 60 60 60 60 60 60 60 60 60 60 60 60 60 60 77 60 60 60 60 60 60 60 60 60 60 60 60 60 60 60 60 77 60 60 60 60 60 60 60 60 60 60 60 60 60 60 60 60 60 60 60 60 60 60 77 77 60 60 60 60 60 60 60 60 60 60 
60 60 60 60 60 60 60 60 60 60 60 60 60 60 60 60 60 60 60 60 60 60 60 60 60 60 60 60 60 60 60 60 60 60 60 60 60 60 60 60 60 60 60 60 60 60 60 77 60 60 60 60 60 60 60 60 60 60 60 60 60 60 60 60 60 60 60 60 60 60 60 60 60 60 60 60 60 60 77 77 60 60 60 60 60 60 60 60 60 60 60 
60 60 60 60 60 60 60 60 60 60 60 60 60 60 60 60 60 60 60 60 60 60 60 60 60 60 60 60 60 60 60 60 60 60 60 60 60 60 60 60 60 60 60 60 60 60 60 60 60 60 60 60 60 60 60 60 60 60 60 60 60 60 60 60 60 60 60 60 60 60 60 60 60 60 60 60 60 60 60 60 60 60 60 60 60 60 60 60 60 60 60 
60 60 60 60 60 60 60 60 60 60 60 60 60 60 60 60 60 60 60 60 60 60 60 60 60 60 60 60 60 60 60 60 60 60 60 60 60 60 60 60 60 60 60 60 60 60 60 60 60 60 60 60 60 60 60 60 60 60 60 60 60 60 60 60 60 60 60 60 60 60 60 60 60 60 60 60 60 60 60 60 60 60 60 60 60 60 60 60 60 60 60 
60 60 60 60 60 60 60 60 60 60 60 60 60 60 60 60 60 60 60 60 60 60 60 60 60 60 60 60 60 60 60 60 60 60 60 60 60 60 60 60 60 60 60 60 60 60 60 60 60 60 60 60 60 60 60 60 60 60 60 60 60 60 60 60 60 60 60 60 60 60 60 60 60 60 60 60 60 60 60 60 60 60 60 60 60 60 60 60 60 60 60