57 57 57 57 57 57 57 57 57 57 57 57 57 57 57 57 57 57 57 57 57 57 57 57 57 57 57 57 57 57 57 57 57 57 57 57 57 57 57 57 57 57 57 57 57 57 57 57 57 57 57 57 57 57 57 57 57 57 57 57 57 57 57 57 57 57 57 57 57 57 57 57 57 57 57 57 57 57 57 57 57 57 57 57 57 57 57 57 57 57 57 57 57 57 57 57 57 57 57 57 57
57 57 57 57 57 57 57 57 57 57 57 57 57 57 57 57 57 57 57 57 57 57 57 57 57 57 57 57 57 57 57 57 57 57 57 57 57 57 57 57 57 57 57 57 57 57 57 57 57 57 57 57 57 57 57 57 57 57 57 57 57 57 57 57 57 57 57 57 57 57 57 57 57 57 57 57 57 57 57 57 57 57 57 57 57 57 57 57 57 57 57 57 57 57 57 57 57 57 57 57 57
57 57 57 57 57 57 57 57 57 57 57 57 57 57 57 57 57 57 57 57 57 57 57 57 57 57 57 57 57 57 57 57 57 57 57 57 57 57 57 57 57 57 57 57 57 57 57 57 57 57 57 57 57 57 57 57 57 57 57 57 57 57 57 57 57 57 57 57 57 57 57 57 57 57 57 57 57 57 57 57 57 57 57 57 57 57 57 57 57 57 57 57 57 57 57 57 57 57 57 57 57
57 57 57 57 57 57 57 57 57 57 57 57 57 57 57 57 57 57 57 57 57 57 57 57 57 57 57 57 57 57 57 57 57 57 57 57 57 57 57 57 57 57 57 57 57 57 57 57 57 57 57 57 57 57 57 57 57 57 57 57 57 57 57 57 57 57 57 57 57 57 57 57 57 57 57 57 57 57 57 57 57 57 57 57 57 57 57 57 57 57 57 57 57 57 57 57 57 57 57 57 57
57 57 57 57 57 57 57 57 57 57 57 57 57 57 57 57 57 57 57 57 57 57 57 57 57 57 57 57 57 57 57 57 57 57 57 57 57 57 57 57 57 57 57 57 57 57 57 57 57 57 57 57 57 57 57 57 57 57 57 57 57 57 57 57 57 57 57 57 57 57 57 57 57 57 57 57 57 57 57 57 57 57 57 57 57 57 57 57 57 57 57 57 57 57 57 57 57 57 57 57 57
57 57 57 57 57 57 57 57 57 57 57 57 57 57 57 57 57 57 57 57 57 57 57 57 57 57 57 57 57 57 57 57 57 57 57 57 57 57 57 57 57 57 57 57 57 57 57 57 57 57 57 57 57 57 57 57 57 57 57 57 57 57 57 57 57 57 57 57 57 57 57 57 57 57 57 57 57 73 57 57 57 57 57 57 57 57 57 57 57 57 57 57 57 57 57 57 57 57 57 57 57
57 57 57 57 57 57 57 57 57 57 57 57 57 57 57 57 57 57 57 57 57 57 57 57 57 57 57 57 57 57 57 57 57 57 57 57 57 73 57 57 57 57 57 57 57 57 57 57 57 57 57 57 57 57 57 57 57 57 57 57 57 57 57 57 57 57 57 57 57 57 57 57 57 57 57 57 57 57 57 57 57 57 57 57 57 57 57 57 57 57 57 57 57 57 57 57 57 57 57 57 57
57 57 57 57 57 57 57 57 57 57 57 57 57 57 57 57 57 57 57 57 57 57 57 57 57 57 57 57 57 57 57 57 57 57 57 57 57 57 57 57 57 57 57 57 57 57 57 57 57 57 57 57 57 57 57 57 57 57 57 57 57 57 57 57 57 57 57 57 57 57 57 57 73 57 57 57 57 57 57 57 57 57 57 57 57 73 57 57 57 57 57 57 57 57 57 57 57 57 57 57 57
57 57 57 57 57 57 57 57 57 57 57 57 57 57 57 57 57 57 57 57 57 57 57 57 57 57 57 57 57 57 57 57 57 57 57 57 57 57 57 57 57 57 57 57 73 57 57 57 57 57 57 57 57 57 57 57 57 57 57 57 57 57 57 57 57 73 57 57 57 57 57 57 57 57 57 57 57 57 57 57 57 57 57 57 57 57 57 57 57 57 73 57 57 57 57 57 57 57 57 57 57
57 57 57 57 57 57 57 57 57 57 57 57 57 57 57 57 57 57 57 73 73 57 57 57 57 57 73 57 57 57 57 57 57 57 57 57 57 57 57 57 57 57 57 57 57 57 57 57 57 57 57 57 57 57 57 57 57 73 57 57 57 57 57 57 57 57 57 57 57 57 57 57 57 57 68 66 66 66 66 70 57 57 57 57 57 57 57 57 57 57 73 73 73 57 57 57 57 57 57 57 57
57 57 57 57 57 57 57 57 57 57 57 57 57 57 57 57 73 73 73 73 57 57 57 57 57 57 57 57 57 57 68 66 66 66 66 66 66 70 57 57 57 57 57 57 57 57 57 57 57 57 57 57 57 57 57 73 57 57 57 57 57 57 57 57 57 57 57 57 57 57 68 66 66 66 69 75 75 75 75 71 66 70 57 57 57 57 57 57 57 57 57 57 57 73 73 57 57 57 57 57 57
57 57 57 57 57 57 57 57 57 57 57 57 57 57 57 73 73 57 57 57 73 57 57 57 57 57 57 57 68 66 69 75 75 75 75 75 75 71 66 66 70 57 57 57 57 57 57 57 57 73 57 57 57 57 57 57 57 57 57 57 57 57 57 57 57 68 66 66 66 66 69 75 75 75 75 75 75 75 75 75 75 71 66 70 57 57 57 57 57 57 57 57 57 57 57 57 57 57 57 57 57
57 57 57 57 57 57 57 57 57 57 57 57 57 57 57 57 57 57 57 73 57 57 57 57 57 57 68 66 69 75 75 75 75 75 75 75 75 75 75 75 71 70 57 57 57 57 57 57 57 57 57 57 57 57 57 57 57 57 57 57 57 57 68 66 66 69 75 75 75 75 75 75 75 75 75 75 75 75 74 75 75 75 75 71 70 57 57 57 57 57 57 57 57 57 57 57 57 57 57 57 57
57 57 57 57 57 57 57 57 57 57 57 57 57 57 57 57 57 57 57 57 57 57 57 57 57 68 69 75 75 75 75 75 75 75 75 74 75 75 75 75 75 75 66 70 57 57 57 57 57 57 57 57 57 57 57 57 57 57 68 66 66 66 69 75 75 75 75 75 75 75 75 75 75 75 75 75 75 75 75 75 75 75 75 75 71 66 70 57 57 73 57 57 57 57 57 57 57 57 57 57 57
57 57 57 57 57 57 57 57 57 57 57 57 57 57 57 57 73 57 57 57 57 57 57 68 66 69 75 75 75 75 75 75 75 75 75 75 75 75 75 75 75 75 75 71 66 66 66 66 66 66 66 66 66 66 66 66 66 66 69 75 75 75 75 75 75 75 74 75 75 75 75 75 75 75 75 75 75 75 75 75 75 74 75 75 75 75 71 70 57 57 57 57 57 57 57 57 57 57 57 57 57
57 57 57 57 57 57 57 57 57 57 57 57 57 57 57 57 57 57 57 57 57 57 68 69 75 75 75 75 75 75 75 75 75 58 58 58 58 58 58 58 75 75 75 75 75 75 75 75 75 75 75 75 75 75 75 75 75 75 75 75 75 75 75 75 75 75 75 75 75 75 75 75 75 75 75 75 75 75 75 75 75 75 75 75 75 75 75 71 70 57 57 57 73 57 57 57 57 57 57 57 57
57 57 57 57 57 57 57 57 57 57 57 57 57 57 57 57 57 57 57 57 68 66 69 75 75 75 75 75 75 74 58 58 58 75 75 75 75 75 75 75 74 58 75 75 75 75 75 75 75 75 75 75 75 75 75 75 75 75 75 75 75 75 75 75 75 75 75 75 75 75 75 75 75 75 75 75 75 75 75 75 75 75 75 75 75 75 75 75 71 70 57 57 57 57 57 57 57 57 57 57 57
57 57 57 57 57 57 57 57 57 57 57 57 57 57 57 57 57 57 68 66 69 75 74 75 75 75 75 75 75 75 58 75 75 75 75 75 75 75 75 75 75 75 75 75 75 75 75 75 75 75 75 75 75 75 75 75 75 58 58 58 75 75 58 58 58 58 58 58 58 58 58 58 58 58 75 89 78 78 78 78 78 78 78 78 90 75 75 75 75 65 57 57 57 57 57 57 57 57 57 57 57
57 57 57 57 57 57 57 57 57 57 57 57 57 73 57 57 57 68 69 75 74 74 74 74 74 75 75 75 75 58 75 75 75 75 75 75 75 75 75 75 75 75 75 75 75 75 75 75 75 75 75 75 75 58 58 58 58 75 75 75 58 58 58 89 78 78 78 78 78 78 78 78 78 78 78 88 58 58 58 75 75 75 75 75 75 75 75 75 75 65 57 57 57 57 57 57 57 57 57 57 57
57 57 57 57 57 57 57 57 57 57 57 57 57 57 57 57 57 67 75 75 75 75 75 75 75 14 78 78 78 78 78 78 78 78 87 58 58 58 58 58 58 58 58 75 75 75 75 75 75 89 78 78 78 78 78 78 13 13 78 78 78 78 78 88 58 75 75 75 58 58 75 75 75 75 75 75 75 58 58 75 75 75 75 75 75 75 75 75 75 65 57 57 57 57 57 57 57 57 57 57 57
57 57 57 57 57 57 57 57 57 57 57 57 57 57 73 57 57 67 75 75 74 74 74 74 74 75 75 58 75 75 75 75 75 75 86 78 78 78 78 78 78 78 78 78 78 78 78 78 78 88 75 75 75 75 75 75 76 12 75 75 75 75 75 58 58 58 58 58 58 75 58 58 58 75 75 75 58 75 75 75 75 75 75 75 75 75 75 75 75 65 57 57 57 57 57 57 57 57 57 57 57
57 57 57 57 57 57 57 57 57 57 57 57 57 57 57 57 57 61 62 75 75 75 75 75 75 75 75 75 75 75 75 75 75 75 75 75 75 75 75 75 75 75 75 75 75 75 75 58 58 58 58 58 75 75 75 58 76 12 75 75 75 75 75 75 75 75 75 75 75 58 58 58 58 75 75 58 75 75 75 75 75 75 75 75 75 75 75 75 75 81 57 57 73 57 57 57 57 57 57 57 57
57 57 57 57 57 57 57 57 57 57 57 57 57 57 57 57 57 57 61 62 75 75 75 75 75 75 75 75 75 75 58 74 75 75 75 75 75 75 75 75 75 75 75 75 75 58 74 75 75 75 75 75 75 58 58 75 76 12 75 75 75 74 75 75 75 75 75 58 74 75 75 75 58 58 58 75 75 75 75 75 75 75 75 75 75 75 75 75 81 57 57 57 57 57 57 57 57 57 57 57 57
57 57 57 57 57 57 57 57 57 57 57 57 57 57 57 57 57 57 57 67 75 75 75 75 75 58 75 75 75 75 75 58 58 58 75 75 75 75 75 75 75 75 75 75 58 75 75 75 75 75 75 75 75 75 75 75 76 12 58 75 75 75 75 75 75 75 75 58 75 75 75 75 75 75 75 75 58 58 75 74 75 75 75 75 75 75 75 81 57 57 57 57 57 57 57 57 57 57 57 57 57
57 57 57 57 57 57 57 57 57 57 57 57 57 57 57 57 57 57 57 61 62 75 75 75 75 58 58 58 75 75 75 75 75 58 58 58 58 75 75 74 75 75 75 58 75 75 75 75 75 75 58 58 75 75 75 75 76 12 75 75 58 75 75 75 75 58 58 75 75 75 75 58 75 75 58 75 75 75 58 58 75 75 75 75 75 64 81 57 57 57 57 57 57 57 57 57 57 57 57 57 57
57 57 57 57 57 57 57 57 57 57 57 57 57 57 57 57 57 73 57 57 67 75 75 75 75 58 75 58 58 75 75 75 75 75 75 58 58 58 58 58 58 58 58 58 58 75 75 75 75 75 75 75 75 58 75 75 76 12 75 75 75 75 75 58 75 75 75 75 75 75 75 74 75 75 75 75 75 75 75 58 58 75 75 75 75 65 57 57 57 73 57 57 57 57 57 57 57 57 57 57 57
57 57 57 57 57 57 73 57 57 57 57 57 57 57 57 57 57 57 57 57 61 62 75 75 75 75 58 75 75 58 74 75 75 75 58 75 58 58 75 75 75 58 75 75 74 75 75 75 75 75 75 74 75 75 58 58 76 12 75 75 75 75 58 58 75 75 75 75 75 75 58 58 75 75 75 75 75 75 75 75 75 58 74 58 75 71 70 57 57 57 57 57 73 57 57 57 57 57 57 57 57
57 57 57 57 57 57 57 57 57 57 68 66 66 66 66 70 57 57 57 57 57 67 75 75 75 75 58 75 75 75 75 58 75 58 58 75 75 75 58 58 58 58 75 75 75 75 75 75 75 75 75 75 75 75 75 75 76 12 75 58 58 58 75 74 75 75 75 75 75 75 75 75 75 75 75 75 75 75 75 74 75 75 74 74 58 75 71 70 57 57 57 57 57 57 57 57 57 57 57 57 57
57 57 57 57 57 57 57 57 57 57 67 75 75 75 75 65 57 57 57 57 57 61 62 75 75 75 58 75 75 75 75 75 58 75 75 75 75 75 75 75 58 58 58 58 75 75 75 75 75 75 75 75 75 75 75 75 76 12 58 75 75 75 75 75 58 58 58 58 75 58 75 58 75 75 75 75 75 75 75 75 75 75 75 74 74 58 75 71 70 57 57 57 57 57 57 57 57 57 57 57 57
57 57 57 57 57 57 57 57 57 57 67 75 58 58 75 71 70 57 57 57 57 57 67 75 75 75 75 58 75 75 75 58 75 58 75 75 75 75 58 58 58 75 75 75 75 75 58 58 58 58 74 75 58 74 75 58 76 12 75 75 75 75 58 75 75 75 75 75 58 58 58 75 75 75 58 75 75 75 75 75 75 75 75 75 75 75 75 75 71 70 57 57 57 57 57 57 57 57 57 57 57
57 57 57 57 57 57 73 57 57 57 67 58 58 58 58 75 71 66 66 66 66 66 69 77 13 13 13 13 13 13 13 13 13 13 13 13 13 13 13 13 13 13 13 13 13 13 13 13 13 13 13 13 13 13 13 13 85 83 13 13 13 13 13 13 13 13 13 13 13 13 13 13 13 11 75 75 75 75 75 75 75 75 75 75 75 75 75 75 75 65 57 57 57 57 57 57 57 57 57 57 57
57 57 57 57 57 57 57 57 57 57 67 58 58 58 58 75 64 59 59 59 59 59 62 10 72 72 72 72 72 72 72 72 72 72 72 72 72 72 72 72 72 72 72 72 72 72 72 72 72 72 72 82 84 72 72 72 72 72 72 72 72 72 72 72 72 72 72 72 72 72 72 72 82 12 58 58 58 58 75 75 58 75 74 75 75 75 75 75 75 71 70 57 57 57 57 57 57 57 57 57 57
57 57 57 57 57 57 57 57 57 57 67 75 58 58 75 64 60 57 57 57 57 57 67 75 75 75 75 75 58 58 75 75 58 58 75 75 58 75 75 75 75 75 58 58 75 75 75 75 75 58 74 76 12 74 58 75 58 58 75 75 75 75 75 75 75 75 58 75 75 58 58 58 76 12 75 75 75 75 58 58 75 75 75 75 75 75 75 75 75 75 71 70 57 57 57 57 57 57 57 57 57
57 57 57 57 57 57 57 57 57 57 67 75 75 75 75 65 57 57 57 57 57 68 69 75 75 75 75 75 58 75 58 58 75 75 75 75 75 75 75 75 75 58 58 75 75 75 58 58 58 75 58 76 12 58 58 58 58 58 58 75 75 75 75 75 75 58 75 75 75 75 75 75 76 83 13 13 13 13 13 13 13 13 13 13 13 11 75 74 75 75 75 65 57 57 57 57 57 57 57 57 57
57 57 57 57 57 57 57 57 57 57 61 59 59 59 59 60 57 57 57 57 57 67 75 75 75 75 75 75 58 74 74 74 74 74 74 74 58 75 75 75 75 58 75 75 75 75 75 58 58 58 58 76 12 75 75 75 75 75 75 75 75 75 75 58 58 75 75 75 75 75 75 75 10 72 72 72 72 72 72 72 72 72 72 72 82 12 75 74 75 75 75 65 57 73 57 57 57 57 57 57 57
57 57 57 57 57 57 57 57 57 57 57 57 57 57 57 57 57 57 57 57 57 67 75 75 75 58 58 58 74 74 74 74 74 74 74 74 75 75 75 75 75 75 75 75 75 58 58 58 75 75 75 76 12 75 75 75 75 75 75 58 58 74 58 75 75 75 75 75 75 75 75 75 58 58 75 75 75 75 75 75 75 75 75 75 76 12 58 74 75 75 75 65 57 57 57 57 57 57 57 57 57
57 57 57 57 57 57 57 57 57 57 57 57 57 57 57 57 57 57 57 57 68 69 75 58 58 75 75 74 74 74 74 74 74 74 74 74 74 74 75 58 75 75 75 58 58 58 75 75 75 75 75 76 12 75 75 75 75 58 58 58 58 58 58 58 75 75 75 74 75 75 75 58 75 75 75 75 75 75 75 75 75 75 75 75 76 12 58 74 74 75 75 65 57 57 57 57 57 57 57 57 57
57 57 57 57 57 57 57 57 57 57 57 57 57 57 57 57 57 57 57 57 67 75 58 75 75 75 75 74 74 74 74 74 74 74 74 74 74 74 75 58 58 58 58 75 58 58 58 75 75 75 75 76 12 58 58 58 58 75 75 75 75 75 75 75 58 58 58 58 58 58 58 58 58 58 58 75 74 75 75 75 75 75 58 58 76 12 58 75 74 74 75 65 57 57 57 57 57 57 57 57 57
57 57 57 57 57 57 57 57 57 57 73 57 57 57 57 57 57 57 57 68 69 75 58 75 75 75 74 74 74 74 74 74 74 74 74 74 74 74 74 74 75 75 58 58 75 75 75 75 75 75 58 76 12 75 75 75 74 75 75 75 75 75 75 75 75 75 58 58 58 75 75 75 75 75 75 75 75 75 75 75 75 75 75 75 10 15 75 75 75 75 75 65 57 57 57 57 57 57 57 57 57
57 57 57 57 57 57 57 57 57 57 57 57 57 57 57 57 57 57 57 67 75 75 75 75 75 75 74 74 74 74 74 74 74 74 74 74 74 58 74 74 58 58 75 75 75 75 75 75 75 75 75 76 12 75 75 75 75 75 75 75 75 54 53 53 53 53 53 53 53 53 53 53 53 53 53 53 53 53 53 53 53 53 53 53 75 56 75 75 75 75 64 81 57 57 57 57 57 57 57 57 57
57 57 57 57 57 57 57 57 57 73 57 57 57 57 57 57 57 57 68 69 75 75 75 75 58 58 74 74 74 74 74 74 74 74 74 74 74 74 74 58 75 75 75 75 75 75 75 75 75 75 75 76 12 75 75 75 75 75 75 75 75 50 75 75 75 75 75 58 58 75 75 75 75 58 75 75 75 75 75 75 75 75 75 75 75 55 75 75 75 75 65 57 57 73 57 57 57 57 57 57 57
57 57 57 57 57 57 57 57 57 73 57 57 57 57 57 57 57 57 67 75 75 75 58 58 75 74 74 74 74 74 74 74 74 74 74 74 74 74 75 75 75 75 75 75 75 75 75 75 75 75 75 10 15 75 75 75 75 75 75 75 75 50 75 75 58 75 75 58 58 75 75 58 75 58 58 58 75 75 75 58 58 75 75 75 75 55 75 75 75 75 65 57 57 57 57 57 57 57 57 57 57
57 57 57 57 57 57 57 57 57 73 57 57 57 57 57 57 57 68 69 58 58 58 75 75 75 74 74 74 74 74 74 74 74 74 74 58 75 75 75 75 75 75 75 75 64 59 59 59 59 59 59 59 59 59 59 59 59 59 59 59 60 49 48 62 58 58 58 58 58 75 75 58 75 75 58 58 58 75 75 58 75 75 75 75 75 55 75 75 75 64 81 57 57 57 57 57 57 57 57 57 57
57 57 57 57 57 57 57 57 57 73 57 57 57 57 57 57 68 69 75 75 75 75 75 75 74 74 58 74 74 74 74 74 74 74 75 75 75 75 75 75 75 75 64 59 60 57 57 57 57 57 57 57 57 57 57 57 57 57 57 57 57 57 57 47 75 75 58 75 58 75 75 58 75 75 75 75 58 75 75 58 58 75 75 75 75 55 75 75 75 65 57 57 57 57 57 57 57 57 57 57 57
57 57 57 57 57 57 57 57 57 57 57 57 57 57 57 68 69 75 75 75 75 75 75 58 74 58 75 75 75 75 75 75 74 74 75 75 75 75 64 59 59 59 60 57 57 57 57 57 57 57 57 57 57 57 57 57 57 57 57 57 57 57 57 46 62 75 75 75 58 75 75 75 75 75 75 75 75 75 75 58 58 75 75 75 75 55 75 75 64 81 57 57 57 57 57 57 57 57 57 57 57
57 57 57 57 57 57 57 73 57 57 57 57 57 57 57 67 75 75 75 75 75 75 75 58 75 58 75 75 75 75 75 75 75 75 75 64 59 59 60 57 57 57 57 57 57 57 57 57 57 68 66 66 66 66 66 66 66 66 66 66 66 37 57 57 45 75 75 75 75 75 75 16 17 18 19 20 75 58 75 58 58 58 58 58 75 55 75 75 65 57 57 57 57 57 57 57 57 57 57 57 57
57 57 57 57 57 57 73 73 57 57 57 57 57 57 57 67 75 75 75 75 75 75 75 75 58 75 75 75 75 75 64 59 59 59 59 60 57 57 57 57 57 57 57 57 57 57 68 66 66 69 75 10 15 75 75 75 75 75 75 75 75 36 57 57 44 62 75 58 58 75 75 31 80 80 80 21 75 58 58 75 58 58 75 75 75 55 75 75 81 57 57 57 57 57 57 57 57 57 57 57 57
57 57 57 57 57 57 73 57 57 57 57 57 57 57 57 61 62 75 75 75 75 75 75 75 58 75 75 64 59 59 60 57 57 57 57 57 57 57 57 57 57 57 68 66 66 66 69 75 75 58 58 58 58 58 75 75 75 75 75 75 75 35 57 57 57 43 62 75 58 75 75 30 80 80 80 22 75 75 58 75 58 75 75 75 75 55 75 81 79 57 73 57 57 57 57 57 57 57 57 57 57
57 57 57 57 57 57 73 73 57 57 57 57 57 57 57 57 67 75 75 75 75 75 75 75 64 59 59 60 57 57 57 57 57 57 57 57 57 57 68 66 66 66 69 75 74 74 75 58 58 75 74 75 75 74 75 75 75 75 75 75 75 50 33 57 73 57 41 75 58 75 75 29 80 80 80 23 75 75 75 75 75 75 58 75 75 55 81 79 57 57 57 57 57 57 57 57 57 57 57 57 57
57 57 57 57 57 57 57 73 57 57 57 73 57 57 57 57 61 59 62 75 75 75 64 59 60 57 57 57 57 57 57 57 57 57 57 68 66 66 69 75 74 74 74 74 74 74 74 74 74 74 74 75 75 74 74 74 74 75 75 75 75 50 34 57 57 57 40 75 75 75 75 28 27 26 25 24 75 75 75 58 58 58 58 75 75 81 79 57 57 57 57 57 57 57 57 57 57 57 57 57 57
57 57 57 57 57 57 57 73 57 57 57 57 73 57 57 57 57 57 61 59 59 59 60 57 57 73 57 57 57 57 68 66 66 66 66 69 75 75 74 74 74 75 75 75 58 75 75 75 75 75 58 58 58 75 75 75 74 74 75 75 75 50 71 32 38 39 42 75 75 75 58 58 75 75 75 75 75 58 75 58 75 75 75 75 81 79 57 57 57 73 57 57 57 57 57 57 57 57 57 57 57
57 57 57 57 57 57 57 57 57 57 57 57 57 57 57 57 57 57 57 57 57 57 57 57 57 57 57 68 66 66 69 75 75 75 74 74 74 74 74 75 75 75 75 75 75 75 75 58 58 58 75 75 75 75 75 75 75 74 74 75 75 50 75 75 75 75 75 75 58 58 58 75 75 75 75 75 75 58 58 58 75 75 75 81 79 57 57 57 57 57 57 57 57 57 57 57 57 57 57 57 57
57 57 57 57 57 57 57 57 57 57 57 57 57 57 57 57 73 57 57 57 57 57 57 57 68 66 66 69 75 75 75 74 74 74 74 75 75 75 75 75 58 75 75 75 75 58 58 75 75 75 75 75 75 75 58 75 75 58 74 74 75 50 75 58 58 75 58 75 58 75 75 75 75 75 75 75 75 75 75 58 75 75 81 79 57 57 57 57 57 57 57 57 57 57 57 57 57 57 57 57 57
57 57 57 57 57 57 57 57 57 57 57 57 57 57 57 57 57 57 57 57 57 57 57 57 67 75 75 74 75 74 74 74 58 75 75 75 58 58 58 58 58 58 75 75 75 58 75 75 75 75 75 75 58 58 58 75 75 58 75 74 75 50 75 58 58 58 58 75 75 58 75 75 75 75 75 75 75 75 75 75 75 81 79 57 57 57 57 57 57 57 57 57 57 57 57 57 57 57 57 57 57
57 57 57 57 57 57 57 57 57 57 57 57 57 57 57 57 57 57 57 73 57 57 57 57 67 75 74 75 75 75 75 75 58 75 75 75 75 75 75 75 58 58 58 75 75 75 58 58 58 58 58 58 75 75 75 75 75 58 75 74 74 50 75 75 75 75 75 75 75 75 75 75 75 75 75 75 75 75 75 75 81 79 57 57 73 57 57 57 57 57 57 57 57 57 57 57 57 57 57 57 57
57 57 57 57 57 57 57 57 57 57 57 57 57 57 57 57 57 57 57 57 57 57 57 57 61 62 75 74 75 74 74 74 58 58 75 75 75 75 75 75 75 75 75 75 75 75 58 75 75 75 75 75 75 75 75 75 75 74 74 74 74 52 51 51 51 51 51 51 51 51 51 51 51 51 51 51 51 51 51 81 79 57 57 57 57 57 57 57 57 57 57 57 57 57 57 57 57 57 57 57 57
57 57 57 57 57 57 57 57 57 57 57 57 57 57 57 57 57 57 57 57 57 57 57 57 57 61 62 75 75 75 75 74 74 74 74 75 75 75 75 75 75 75 75 58 58 75 75 75 75 75 74 74 74 74 74 74 74 74 75 75 75 75 75 75 75 75 75 75 75 75 75 75 75 64 59 59 59 59 81 79 57 57 57 57 57 57 57 57 57 57 57 57 57 57 57 57 57 57 57 57 57
57 57 57 57 57 57 57 57 57 57 57 57 57 57 57 57 57 57 57 57 57 57 57 57 57 57 61 59 59 59 59 59 59 62 74 74 74 74 74 74 74 74 74 74 74 74 74 74 74 74 74 75 75 75 75 75 75 58 75 75 75 75 75 75 75 75 75 75 75 64 59 59 59 81 57 57 57 57 57 57 57 57 73 57 57 57 57 57 57 57 57 57 57 57 57 57 57 57 57 57 57
57 57 57 57 57 57 57 57 57 57 57 57 57 57 57 57 57 57 57 57 57 57 57 73 57 57 57 57 57 57 57 57 57 61 59 59 59 59 59 59 59 62 75 75 75 75 58 58 75 75 75 75 75 75 75 75 75 75 75 75 75 75 75 75 64 59 59 59 59 60 57 57 73 57 57 57 57 57 57 57 57 57 57 57 57 57 57 57 57 57 73 57 57 57 57 57 57 57 57 57 57
57 57 57 57 57 57 57 57 57 57 73 73 57 57 57 57 57 57 57 57 57 57 57 57 57 57 57 57 57 57 57 57 57 57 57 57 57 57 57 57 57 61 59 59 59 59 59 59 59 59 62 75 75 64 63 62 75 75 75 64 59 59 59 59 81 57 57 57 57 57 57 57 57 57 57 57 57 57 57 57 57 57 57 57 57 57 57 57 57 73 73 57 57 57 57 57 57 57 57 57 57
57 57 57 57 57 57 57 57 57 57 57 57 73 73 57 57 57 57 57 57 57 57 57 57 57 57 57 57 57 57 73 57 57 57 57 57 57 57 57 57 57 57 57 57 57 57 57 57 57 57 61 59 59 60 79 61 59 59 59 60 57 57 57 57 57 57 57 57 57 73 57 57 57 57 57 57 57 57 57 57 57 57 57 57 57 57 73 73 73 73 57 57 57 57 57 57 57 57 57 57 57
57 57 57 57 57 57 57 57 57 57 57 57 57 57 73 73 57 57 57 57 57 57 57 57 57 57 57 57 57 57 57 57 57 57 57 57 57 57 57 57 57 57 57 57 73 57 57 57 57 57 57 57 57 57 57 57 57 57 57 57 57 73 57 57 57 57 57 57 57 57 57 57 57 57 57 57 57 57 57 57 57 57 57 57 73 73 57 57 57 57 57 57 57 57 57 57 57 57 57 57 57
57 57 57 57 57 57 57 57 57 57 57 57 57 57 57 57 57 57 57 57 57 57 57 57 57 57 57 57 57 57 57 57 57 57 57 57 57 57 57 57 57 57 57 57 57 57 57 57 57 57 57 57 73 57 57 57 57 57 57 57 57 57 57 57 57 57 57 57 57 57 57 57 57 57 57 57 57 57 57 57 57 57 57 73 73 57 57 57 57 57 57 57 57 57 57 57 57 57 57 57 57
57 57 57 57 57 57 57 57 57 57 57 57 57 57 57 57 57 57 57 57 57 57 57 57 57 57 57 57 57 57 57 57 57 57 57 57 57 57 57 57 57 57 57 57 57 57 57 57 57 57 57 57 57 57 57 57 57 57 57 57 57 57 57 57 57 57 57 57 57 57 57 57 57 57 57 57 57 57 57 57 57 57 57 57 57 57 57 57 57 57 57 57 57 57 57 57 57 57 57 57 57
57 57 57 57 57 57 57 57 57 57 57 57 57 57 57 57 57 57 57 57 57 57 57 57 57 57 57 57 57 57 57 57 57 57 57 57 57 57 57 57 57 57 57 57 57 57 57 57 57 57 57 57 57 57 57 57 57 57 57 57 57 57 57 57 57 57 57 57 57 57 57 57 57 57 57 57 57 57 57 57 57 57 57 57 57 57 57 57 57 57 57 57 57 57 57 57 57 57 57 57 57
57 57 57 57 57 57 57 57 57 57 57 57 57 57 57 57 57 57 57 57 57 57 57 57 57 57 57 57 57 57 57 57 57 57 57 57 57 57 57 57 57 57 57 57 57 57 57 57 57 57 57 57 57 57 57 57 57 57 57 57 57 57 57 57 57 57 57 57 57 57 57 57 57 57 57 57 57 57 57 57 57 57 57 57 57 57 57 57 57 57 57 57 57 57 57 57 57 57 57 57 57
57 57 57 57 57 57 57 57 57 57 57 57 57 57 57 57 57 57 57 57 57 57 57 57 57 57 57 57 57 57 57 57 57 57 57 57 57 57 57 57 57 57 57 57 57 57 57 57 57 57 57 57 57 57 57 57 57 57 57 57 57 57 57 57 57 57 57 57 57 57 57 57 57 57 57 57 57 57 57 57 57 57 57 57 57 57 57 57 57 57 57 57 57 57 57 57 57 57 57 57 57
57 57 57 57 57 57 57 57 57 57 57 57 57 57 57 57 57 57 57 57 57 57 57 57 57 57 57 57 57 57 57 57 57 57 57 57 57 57 57 57 57 57 57 57 57 57 57 57 57 57 57 57 57 57 57 57 57 57 57 57 57 57 57 57 57 57 57 57 57 57 57 57 57 57 57 57 57 57 57 57 57 57 57 57 57 57 57 57 57 57 57 57 57 57 57 57 57 57 57 57 57
57 57 57 57 57 57 57 57 57 57 57 57 57 57 57 57 57 57 57 57 57 57 57 57 57 57 57 57 57 57 57 57 57 57 57 57 57 57 57 57 57 57 57 57 57 57 57 57 57 57 57 57 57 57 57 57 57 57 57 57 57 57 57 57 57 57 57 57 57 57 57 57 57 57 57 57 57 57 57 57 57 57 57 57 57 57 57 57 57 57 57 57 57 57 57 57 57 57 57 57 57
57 57 57 57 57 57 57 57 57 57 57 57 57 57 57 57 57 57 57 57 57 57 57 57 57 57 57 57 57 57 57 57 57 57 57 57 57 57 57 57 57 57 57 57 57 57 57 57 57 57 57 57 57 57 57 57 57 57 57 57 57 57 57 57 57 57 57 57 57 57 57 57 57 57 57 57 57 57 57 57 57 57 57 57 57 57 57 57 57 57 57 57 57 57 57 57 57 57 57 57 57
57 57 57 57 57 57 57 57 57 57 57 57 57 57 57 57 57 57 57 57 57 57 57 57 57 57 57 57 57 57 57 57 57 57 57 57 57 57 57 57 57 57 57 57 57 57 57 57 57 57 57 57 57 57 57 57 57 57 57 57 57 57 57 57 57 57 57 57 57 57 57 57 57 57 57 57 57 57 57 57 57 57 57 57 57 57 57 57 57 57 57 57 57 57 57 57 57 57 57 57 57